           1          -1
           2           1
           3           1
           4           2
           5           2
           6           1
           7           2
           8           2
           9           2
          10           2
          11           2
          12           2
          13           1
          14           1
          15           3
          16           4
          17           2
          18           3
          19           4
          20           1
          21           3
          22           4
          23           2
          24           3
          25           4
          26           1
          27           1
          28           1
          29           1
          30           1
          31           1
          32           1
          33           3
          34           3
          35           4
          36           4
          37           2
          38           2
          39           3
          40           3
          41           4
          42           4
          43           2
          44           1
          45           3
          46           3
          47           4
          48           4
          49           2
          50           2
          51           3
          52           3
          53           4
          54           4
          55           2
          56           1
          57           3
          58           3
          59           4
          60           4
          61           2
          62           1
          63           2
          64           3
          65           3
          66           2
          67           2
          68           1
          69           3
          70           3
          71           4
          72           4
          73           2
          74           2
          75           3
          76           3
          77           4
          78           4
          79           2
          80           1
          81           2
