           1          -1
           2           1
           3          -2
           4           2
           5           2
           6           2
           7          -3
           8           1
           9          -8
          10          -4
          11          -5
          12          -6
          13          -7
          14           1
          15           6
          16           4
          17           1
          18           2
          19           7
          20           4
          21           5
          22           4
          23           1
          24           2
          25           3
          26           3
          27           8
          28           4
          29           5
          30           3
          31           6
          32           7
          33           3
          34           3
          35           1
          36          -9
