           1          -1
           2           2
           3           2
           4           2
           5           3
           6           2
           7           1
           8           2
           9           2
          10           1
          11           2
          12           1
          13           2
          14           2
          15           2
          16           2
          17           1
          18           2
          19           1
          20           2
          21           2
          22           2
          23           1
          24           2
          25           2
          26           2
          27           2
          28           1
          29           1
          30           1
          31           2
          32           1
          33           2
          34           1
          35           1
          36           1
          37           2
          38           2
          39           1
          40           1
          41           1
          42           2
          43           2
          44           3
          45           2
          46           1
          47           2
          48           1
          49           1
          50           1
          51           2
          52           2
          53           2
          54           2
          55           1
          56           2
          57           2
          58           2
          59           2
          60           1
          61           2
          62           1
          63           2
          64           1
          65           1
          66           1
          67           1
          68           2
          69           2
          70           2
          71           2
          72           1
          73           1
          74           1
          75           2
          76           1
          77           2
          78           1
          79           1
          80           1
          81           1
          82           2
          83           2
          84           2
          85           1
          86           1
          87           1
          88           1
          89           1
          90           2
          91           1
          92           1
          93           1
          94           1
          95           2
          96           2
          97           1
          98           2
          99           2
         100           2
         101           2
         102           2
         103           2
         104           2
         105           2
         106           2
         107           2
         108           1
         109           1
         110           2
         111           2
         112           1
         113           2
         114           3
         115           2
         116           1
         117           2
         118           2
         119           1
         120           2
         121           2
         122           2
         123           1
         124           1
         125           2
         126           1
         127           1
         128           2
         129           1
         130           2
         131           1
         132           1
         133           1
         134           2
         135           2
         136           1
         137           2
         138           1
         139           2
         140           1
         141           2
         142           1
         143           1
         144           2
         145           1
         146           2
         147           1
         148           2
         149           2
         150           2
         151           1
         152           1
         153           2
         154           2
         155           1
         156           1
         157           1
         158           2
         159           1
         160           1
         161           1
         162           2
         163           2
         164           2
         165           2
         166           2
         167           2
         168           2
         169           1
         170           1
         171           1
         172           3
         173           1
         174           1
         175           1
         176           2
         177           1
         178           1
         179           2
         180           1
         181           1
         182           2
         183           1
         184           2
         185           1
         186           2
         187           1
         188           1
         189           2
         190           2
         191           2
         192           1
         193           1
         194           2
         195           2
         196           1
         197           2
         198           2
         199           2
